111111111
100000C01
1P0000001
10C000E01
100000001
111111111
